//1,2,3,4,5,6,7,8,9,10,11,12,13,14,15,16,17,18,19,20,21,22,23,24,25,26,27,28,29,30,31,32,33,34,35,36,37,38,39,40,41,42,43,44,45,46,47,48,49,50,51,52,53,54,55,56,57,58,59,60,61,62,63,64
101,101,101,101,101,101,101,101,101,101,101,101,101,101,102,102,102,102,102,102,102,102,101,101,101,102,102,102,102,102,102,102,101,101,101,101,101,101,101,101,101,101,102,102,102,102,102,102,102,102,101,101,101,101,101,101,101,101,101,101,101,101,101,101
101,101,101,101,101,101,101,101,101,101,101,101,101,101,0,0,0,0,0,0,0,0,101,101,23,0,0,0,0,0,0,0,101,101,101,101,101,101,101,101,101,101,0,0,0,0,0,0,0,0,101,101,101,101,101,101,101,101,101,101,101,101,101,101
101,101,101,101,101,101,101,101,101,101,101,101,101,101,0,0,0,0,0,0,0,0,101,23,22,0,0,0,0,0,0,0,101,101,101,101,101,101,101,101,101,101,0,0,0,0,0,0,0,0,101,101,101,101,101,101,101,101,101,101,101,101,101,101
101,101,101,101,101,101,101,101,101,101,101,101,101,101,0,0,0,0,0,0,0,0,23,22,0,0,0,0,0,0,0,0,101,101,101,101,101,101,101,101,101,101,0,0,0,0,0,0,0,0,101,101,101,101,101,101,101,101,101,101,101,101,101,101
101,101,101,101,101,101,101,101,101,101,101,101,101,101,0,0,0,0,0,0,0,0,22,0,0,0,0,0,0,0,0,0,23,23,23,23,23,23,23,23,23,23,0,0,0,0,0,0,0,0,101,101,101,101,101,101,101,101,101,101,101,101,101,101
101,101,101,101,101,101,101,101,101,101,101,101,101,101,0,0,0,0,0,0,0,0,0,0,0,0,0,0,0,0,0,0,22,22,22,22,22,22,22,22,22,22,0,0,0,0,0,0,0,0,101,101,101,101,101,101,101,101,101,101,101,101,101,101
101,101,102,102,102,102,102,102,23,101,101,101,101,101,0,0,0,0,0,0,0,0,0,0,0,20,0,0,0,0,0,0,0,0,0,0,26,0,0,0,0,0,0,0,0,0,0,0,0,0,101,101,101,101,101,101,101,101,101,101,101,101,101,101
101,103,0,0,0,0,0,0,22,23,101,101,101,101,0,0,0,0,0,0,0,0,0,0,20,21,0,0,0,0,0,0,0,0,0,0,26,0,0,0,0,0,0,0,0,0,0,0,0,0,101,101,101,101,101,101,101,101,101,101,101,101,101,101
101,103,0,0,0,0,0,0,0,22,23,101,101,101,0,0,0,0,0,10,0,0,0,20,21,101,0,0,2,0,0,0,20,20,20,20,20,20,20,20,20,20,0,0,10,0,0,0,0,0,101,101,101,101,101,101,101,101,101,101,101,101,101,101
101,103,0,0,0,0,0,0,0,0,22,23,101,101,0,0,0,0,0,0,0,0,20,21,101,101,0,0,0,0,0,0,21,21,21,21,21,21,21,21,21,21,0,0,2,0,0,0,0,0,101,101,101,101,101,101,101,101,101,101,101,101,101,101
101,103,0,0,0,0,0,0,0,0,0,22,23,101,0,0,0,105,100,100,100,100,21,101,101,101,100,100,100,100,100,100,101,101,101,101,101,101,101,101,101,101,0,0,0,0,0,0,0,0,101,101,101,101,101,101,101,101,101,101,101,101,101,101
101,103,0,0,0,0,0,20,0,0,0,0,22,23,0,0,0,104,101,101,101,101,101,101,101,101,101,101,101,101,101,101,101,101,101,101,101,101,101,101,101,101,100,100,100,100,106,0,0,0,23,23,23,23,23,23,23,23,23,23,23,23,101,101
101,103,0,0,0,0,0,21,20,0,0,0,0,22,0,0,0,104,101,101,101,101,101,101,101,101,101,101,101,101,101,101,101,101,101,101,101,101,101,101,101,101,101,101,101,101,103,0,0,0,22,22,22,22,22,22,22,22,22,22,22,22,104,101
101,103,0,0,0,0,0,101,21,20,0,0,0,0,0,0,0,104,101,101,101,101,101,101,101,101,101,101,101,101,101,101,101,101,101,101,101,101,101,101,101,101,101,101,101,101,103,0,0,0,0,0,0,0,0,0,0,0,0,0,0,0,104,101
101,103,99,0,0,0,0,101,101,21,20,0,0,0,0,0,0,104,101,101,101,101,101,101,101,101,101,101,101,101,101,101,101,101,101,101,101,101,101,101,101,101,101,101,101,101,103,0,0,0,0,0,0,0,0,0,0,0,0,0,0,0,104,101
101,103,0,0,0,0,0,101,101,101,21,20,0,0,0,0,0,104,101,101,101,101,101,101,101,101,101,101,101,101,101,101,101,101,101,101,101,101,101,101,101,101,101,101,101,101,103,0,24,0,0,0,0,0,0,0,0,0,0,0,0,0,104,101
101,103,0,0,0,0,0,101,101,101,101,21,20,0,0,0,0,104,101,101,101,101,101,101,101,101,101,101,101,101,101,101,101,101,101,101,101,101,101,101,101,101,101,101,101,101,103,0,0,0,0,0,0,0,0,0,0,0,0,0,0,0,104,101
101,103,0,0,0,0,0,101,101,101,101,101,21,20,0,0,0,104,101,101,101,101,101,101,101,101,101,101,101,101,101,101,101,101,101,101,101,101,101,101,101,101,101,101,101,101,103,0,0,0,0,0,0,0,0,0,0,0,0,0,0,0,104,101
101,103,0,0,2,0,0,101,101,101,101,101,101,21,0,0,0,104,101,101,101,101,101,101,101,101,101,101,101,101,101,101,101,101,101,101,101,101,101,101,101,101,101,101,101,101,103,20,20,20,20,20,20,20,20,0,0,0,0,0,0,0,104,101
101,103,0,0,0,0,0,101,101,101,101,101,101,101,0,0,0,104,101,101,101,101,101,101,101,101,101,101,101,101,101,101,101,101,101,101,101,101,101,101,101,101,101,101,101,101,101,21,21,21,21,21,21,21,21,0,0,0,0,0,0,0,104,101
101,101,100,100,100,100,100,101,101,101,101,101,101,101,100,100,100,101,101,101,101,101,101,101,101,101,101,101,101,101,101,101,101,101,101,101,101,101,101,101,101,101,101,101,101,101,101,101,101,101,101,101,101,101,101,0,0,0,0,0,0,0,104,101
101,101,101,101,101,101,101,101,101,101,101,101,101,101,101,101,101,101,101,101,101,101,101,101,101,101,101,101,101,101,101,101,101,101,101,101,101,101,101,101,102,102,102,102,102,102,102,102,102,102,101,101,101,101,101,0,0,0,0,28,0,0,104,101
101,101,101,101,101,101,101,101,101,101,101,101,101,101,101,101,101,101,101,101,101,101,101,101,101,101,101,101,101,101,101,101,101,101,101,101,101,101,101,101,0,0,0,0,0,0,0,0,0,0,101,101,101,101,101,0,0,0,0,0,0,0,104,101
101,101,101,101,101,101,101,101,101,101,101,101,101,101,101,101,101,101,101,101,101,101,101,101,101,101,101,101,101,101,101,101,101,101,101,101,101,101,101,101,0,0,0,0,0,0,0,0,0,0,101,101,101,101,101,0,0,0,0,0,0,0,104,101
101,101,101,101,101,101,101,101,101,101,101,101,101,101,101,101,101,101,101,101,101,101,101,101,101,101,101,101,101,101,101,101,101,101,101,101,101,101,101,101,0,0,0,0,0,0,0,0,0,0,101,101,101,101,101,0,0,0,105,100,100,100,101,101
101,101,101,101,101,101,101,101,101,101,101,101,101,101,101,101,101,101,101,101,101,101,101,101,101,101,101,101,101,101,101,101,101,101,101,101,101,101,101,101,0,0,0,0,0,0,0,0,0,0,101,101,101,101,101,0,0,0,104,101,101,101,101,101
101,101,102,102,102,102,102,102,102,102,102,102,102,102,102,102,102,102,101,101,101,101,101,101,101,101,101,101,101,101,101,101,101,101,101,101,101,101,101,101,0,0,0,0,0,0,0,0,0,0,101,101,101,101,101,0,0,0,104,101,101,101,101,101
101,103,0,0,0,0,0,0,0,0,0,0,0,0,0,0,0,0,101,101,101,101,101,101,101,101,101,101,101,101,101,101,101,101,101,101,101,101,101,101,0,0,0,0,0,0,0,0,0,0,101,101,101,101,101,0,0,0,104,101,101,101,101,101
101,103,0,0,0,0,0,0,0,0,0,0,0,0,0,0,0,0,101,101,101,101,101,101,101,101,101,101,101,101,101,101,101,101,101,101,101,101,101,101,0,0,0,0,0,0,0,0,0,0,23,23,23,23,23,0,0,0,104,101,101,101,101,101
101,103,0,0,0,0,0,0,0,0,0,0,0,0,0,0,0,0,101,101,101,101,101,23,23,23,23,23,23,23,23,23,23,23,23,23,23,23,23,23,0,0,0,0,0,0,0,0,0,0,22,22,22,22,22,0,0,0,104,101,101,101,101,101
101,103,0,0,0,0,0,0,0,0,0,0,0,0,0,0,0,0,101,101,101,101,101,22,22,22,22,22,22,22,22,22,22,22,22,22,22,22,22,22,0,0,0,0,0,0,0,0,0,0,0,0,0,0,0,0,0,0,104,101,101,101,101,101
101,103,0,0,0,0,0,0,0,0,0,0,0,0,0,0,0,0,101,101,101,101,101,0,0,0,0,0,0,0,0,0,0,0,0,0,0,0,0,0,0,0,0,0,0,0,0,0,2,0,0,0,0,0,0,0,0,0,104,101,101,101,101,101
101,103,0,0,0,0,0,0,0,0,0,0,0,0,0,0,0,0,23,23,23,23,23,0,0,0,0,0,0,0,0,0,0,0,0,0,0,0,0,0,0,0,0,0,0,0,0,0,0,0,0,0,0,0,0,0,24,0,104,101,101,101,101,101
101,103,0,0,0,0,0,0,0,0,0,0,0,0,0,0,0,0,22,22,22,22,22,0,0,0,0,0,0,0,0,0,0,0,0,0,0,0,0,0,0,0,0,0,0,0,100,100,100,100,100,0,0,0,0,0,0,0,104,101,101,101,101,101
101,103,0,0,0,0,0,0,0,0,0,0,0,0,0,0,0,0,0,0,2,0,0,0,0,0,0,0,0,0,0,0,0,0,0,0,0,0,0,0,0,0,0,0,0,0,101,101,101,101,101,0,0,0,0,0,0,0,104,101,101,101,101,101
101,103,0,0,0,0,0,0,0,0,0,0,0,0,0,0,0,0,20,20,20,20,20,0,0,0,0,0,0,0,0,0,0,27,0,0,0,0,0,0,0,0,0,0,0,0,101,101,101,101,101,0,0,0,0,0,0,0,104,101,101,101,101,101
101,103,0,0,0,0,0,0,0,0,0,0,0,0,0,0,0,0,21,21,21,21,21,0,0,0,0,0,0,0,0,0,0,0,0,0,0,0,0,0,0,0,0,0,0,0,101,101,101,101,101,0,0,0,0,0,0,0,104,101,101,101,101,101
101,103,0,0,0,0,0,0,0,0,0,0,0,0,0,0,0,0,101,101,101,101,101,0,0,0,0,0,0,0,0,0,0,0,0,0,0,0,0,0,0,0,0,0,0,0,101,101,101,101,101,0,0,0,0,0,0,0,104,101,101,101,101,101
101,103,0,0,0,0,0,0,0,0,0,0,0,0,0,0,0,0,101,101,101,101,101,0,0,10,0,0,0,0,0,0,0,0,0,0,0,0,0,0,0,0,0,0,0,0,101,101,101,101,101,0,0,0,0,0,0,0,104,101,101,101,101,101
101,103,0,0,0,0,0,0,0,0,0,0,0,0,0,0,0,0,101,101,101,101,101,0,0,0,0,0,0,0,0,0,0,0,0,0,0,0,0,0,0,0,0,0,0,0,101,101,101,101,101,0,0,0,0,0,0,0,104,101,101,101,101,101
101,103,0,0,0,0,0,0,0,0,0,0,0,0,0,24,0,0,101,101,101,101,101,100,100,100,100,100,20,20,20,20,20,20,20,20,20,20,20,20,20,20,20,20,20,20,101,101,101,101,101,0,0,0,0,0,0,0,104,101,101,101,101,101
101,103,0,0,0,0,0,0,0,0,0,0,0,0,0,0,0,0,101,101,101,101,101,101,101,101,101,101,21,21,21,21,21,21,21,21,21,21,21,21,21,21,21,21,21,21,101,101,101,101,101,0,0,0,0,0,0,0,104,101,101,101,101,101
101,103,0,0,200,0,0,0,0,0,0,0,0,0,0,0,0,0,101,101,101,101,101,101,101,101,101,101,101,101,101,101,101,101,101,101,101,101,101,101,101,101,101,101,101,101,101,101,101,101,101,0,0,0,0,0,0,0,104,101,101,101,101,101
101,103,0,0,0,0,0,0,0,0,0,0,0,0,0,0,0,0,101,101,101,101,101,101,101,101,101,101,101,101,101,101,101,101,101,101,101,101,101,101,101,101,101,101,101,101,101,101,101,101,101,0,0,0,0,0,0,0,104,101,101,101,101,101
101,103,0,0,0,0,0,0,0,0,0,0,0,0,0,0,0,0,101,101,101,101,101,101,101,101,101,101,101,101,101,101,101,101,101,101,101,101,101,101,101,101,101,101,101,101,101,101,101,101,101,20,20,20,20,20,20,20,104,101,101,101,101,101
101,101,100,100,100,100,100,100,100,100,100,100,100,100,100,100,100,100,101,101,101,101,101,101,101,101,101,101,101,101,101,101,101,101,101,101,101,101,101,101,101,101,101,101,101,101,101,101,101,101,101,21,21,21,21,21,21,21,101,101,101,101,101,101
101,101,101,101,101,101,101,101,101,101,101,101,101,101,101,101,101,101,101,101,101,101,101,101,101,101,101,101,101,101,101,101,101,101,101,101,101,101,101,101,101,101,101,101,101,101,101,101,101,101,101,101,101,101,101,101,101,101,101,101,101,101,101,101
101,101,101,101,101,101,101,101,101,101,101,101,101,101,101,101,101,101,101,101,101,101,101,101,101,101,101,101,101,101,101,101,101,101,101,101,101,101,101,101,101,101,101,101,101,101,101,101,101,101,101,101,101,101,101,101,101,101,101,101,101,101,101,101
